5, 5
35
1, 1, 1, 1, 1, 1, 1, 1, -1, 1, 1, 1, 1, 1, 1, 8, 1, 1, 1, 1, 1, 1, 1, 1, 1, 1, 1, 0, 1, 5, 1, 1, 1, 1, 1, 1, 8, 1, 1, 1, 1, 8, 1, 1, 1, 1, 6, 4, 1, 1, 1, 0, 1, 1, 1, 5, 1, 1, 1, 1, 1, 4, 1, 1, 1, 1, 1, 1, 1, 1 
1, 1, 1, 7, 1, 1, 1, 1, 1, 1, 1, 1, 1, 1, 1, 1, 1, 1, 1, 1, 1, 1, 7, 1, 7, 9, 1, 1, 1, 1, 1, 0, 1, 1, 1, 1, 1, 1, 3, 1, 7, 1, 1, 1, 1, 1, 1, 1, 1, 1, 1, 1, 1, 3, 8, 1, 1, 1, 1, 8, 1, 1, 1, 1, 0, 7, 1, 9, 1, 1 
1, 1, 1, 1, 1, 1, 1, 1, 1, 1, 6, 1, 1, 1, 6, 1, 3, 1, 1, 1, 1, 1, 1, 1, 1, 1, 1, 1, 1, 1, -5, 1, 1, 1, 8, 1, 1, 1, 8, 1, 5, 1, 1, 1, 1, 1, 1, 9, -3, 7, 1, 1, 1, 1, 1, 1, 1, 5, 1, 1, 1, 1, 1, 1, 1, -8, 9, 2, 1, 1 
0, 1, 1, 1, 1, 5, 1, 3, 1, 1, 1, 1, 1, 1, 1, 1, 1, 1, 1, 1, 1, 1, 1, 1, 1, 0, 1, 6, 1, 1, 1, 1, 1, 1, 1, 1, 1, 1, 5, 1, 1, 4, 1, 6, 1, 9, 1, 1, 1, 1, 1, 1, 1, 1, 1, 1, 1, 1, 1, 1, 1, 5, 1, 1, 1, 1, 7, 1, 1, 1 
1, 1, 1, 1, 1, 6, 1, 1, 1, 1, 4, 6, 6, 1, 1, 5, 0, 1, 1, 1, 1, 1, 1, 1, 1, 5, 1, 2, 1, -3, 1, 1, 1, 1, 1, 2, 1, 1, 1, 1, 1, 1, 1, 1, 1, 1, 1, 1, 1, 1, 1, 1, 5, -9, 1, 1, 1, 1, 1, 1, 1, 1, 1, 1, 1, 1, 1, 1, 1, 1 
1, 1, 0, 1, 1, 1, 3, 1, 1, 1, 1, 7, 1, 4, 0, -4, 1, 1, 1, 1, 1, 1, 4, 4, 1, 1, 1, 2, 1, 1, 1, 1, 7, 1, 1, 1, 1, -7, 5, 1, 1, 1, 1, 1, 1, 1, 3, 1, 1, 1, 9, 3, 1, 1, 1, 0, 3, 1, 1, 1, 1, 1, 3, 1, 1, 1, 7, 1, 1, 1 
9, 1, 1, 1, 1, 1, 1, 1, 4, 1, 0, 1, 1, 9, 1, 1, 1, 1, 1, 1, 1, 2, 9, 1, 4, 1, 1, 1, 1, 1, 1, 4, 1, 1, 1, 1, 7, 1, 1, -3, 1, 1, 1, 1, 8, 1, 1, 1, 1, 1, 1, 1, 1, 1, -1, 1, 1, 4, 1, 1, 1, 1, 1, 9, 1, 1, 2, 1, 1, 6 
5, 1, 1, 1, 1, 1, 1, 1, 1, 1, 1, 0, 1, 5, 1, 1, 1, 0, 1, 1, 7, 1, 1, 1, 1, 1, 1, 1, 2, 1, 1, 1, 1, 1, 1, 1, 0, 1, 1, 1, 1, 1, 1, 1, 1, 1, 1, 1, 1, 0, 1, 1, 1, 1, 1, 1, 1, 1, 1, 1, 7, 1, 2, 1, 1, 1, 1, 4, 1, 1 
1, 1, 1, 1, 3, 1, 1, 1, 1, 1, 1, 1, 1, 1, 1, 1, 1, 1, 4, 1, 1, 1, 1, 1, 1, 1, 1, 1, 1, 6, 1, 1, 1, 1, 4, 1, 1, 1, 1, 4, 1, 1, 1, 1, 1, 2, 2, 1, 1, 0, 1, 1, -4, 1, 4, 1, 1, 1, 1, 1, 1, 1, 1, 1, 2, 1, 0, 1, 1, 1 
-9, 1, 1, 6, 3, 1, 0, 1, 1, 1, 1, 2, 1, 1, 1, 9, 1, 1, 1, 1, 1, 1, 1, 1, 1, 1, 1, 1, 1, 1, 1, 1, 1, 1, 1, 1, 1, 1, 1, -8, 1, 1, 1, 1, 1, 1, 1, 1, 1, 3, 1, 1, 1, 1, 1, 1, 1, 5, 1, 1, 1, 1, 1, 1, 1, 1, 3, 1, 1, 1 
1, 1, 1, 1, 1, 7, 1, 1, 1, 1, 1, 1, 1, 1, 1, 1, 1, 1, 1, 1, 1, 1, 1, 1, 5, 1, 1, 2, 1, 1, 1, 1, -7, 1, 1, 1, 3, 1, 1, 1, 1, 1, 1, 1, 1, 1, 1, 8, 1, 1, 1, 1, 1, 1, 1, 1, 6, 1, 1, 1, 1, 1, 1, 1, 1, 1, 1, 6, -2, 1 
1, 1, 1, 1, 7, 2, 1, 1, 1, 1, 1, 3, 1, 1, 1, 6, 1, 6, 1, 1, 1, 3, 1, 4, 1, 1, 7, 1, 1, 1, 1, 1, 1, 1, 1, 1, 1, 1, 1, 1, 1, 1, 1, 1, 1, 1, 1, 1, 1, 1, 5, 1, 1, 1, 1, 1, 1, 1, 8, 0, 1, 1, 1, 1, 1, 4, 1, 1, 1, 9 
1, 1, 1, 1, 9, 1, 1, 1, 1, 1, 1, 1, 1, 1, 1, 1, 1, 1, 1, 1, 7, 8, 1, 1, 1, 1, 1, 9, 1, 1, 5, 1, 1, 1, 1, 2, 1, 1, 1, 1, 1, 1, 1, 6, 1, 1, 1, 2, 1, 1, 1, 1, 1, 1, 2, 1, 1, 1, 1, 1, 1, 1, 1, 5, 1, 1, 1, 3, 1, 1 
1, 1, 1, 1, 7, 1, 1, 1, 1, 1, 1, 1, 1, 1, 1, 1, 3, 1, 1, 1, 1, 1, 1, 1, 1, 1, 1, 1, 2, 7, 1, 1, 1, 1, 4, 1, 1, 1, 1, 1, 1, 1, 1, 1, 1, 1, 1, 1, 1, 1, 1, 1, 1, 1, 1, 1, 1, 1, 1, 1, 6, 0, 1, 8, 1, 1, 1, 1, 0, 1 
1, 1, 1, 1, 1, 1, 1, 5, 1, 1, 1, 4, 0, 1, 7, 1, 9, 1, 1, 1, 1, 1, 2, 1, 1, 1, 1, 1, 1, 1, 1, 1, 1, -1, 1, 1, 9, 1, 1, 1, 1, 0, 1, 4, 1, 1, 0, 1, 1, 1, 1, 2, 1, 1, 1, 1, 1, 1, 1, 1, 1, 3, 4, 6, 1, 2, 1, 1, 1, 0 
1, 1, 1, 1, 1, 1, 1, 1, 1, 1, 1, 1, 1, 1, 1, 1, 1, 1, 1, 1, 1, 1, 8, 1, 1, 1, -3, 1, 0, 1, 7, 1, 1, 1, 2, 1, 1, 1, 1, 1, 1, 1, 1, 1, 1, 1, 1, 3, 1, 1, 1, 1, 1, 1, 9, 1, 1, 1, 1, 1, 1, 1, 1, 1, 1, 1, 1, 1, 1, 1 
1, 1, 1, 1, 8, 1, 1, 3, 1, 1, 4, 1, 1, 1, -6, 1, 1, 1, 1, -9, 1, 1, 1, 1, 1, 1, 1, 1, 1, 1, 1, 1, 1, 1, 1, 1, 4, 1, 1, 1, 1, 1, 1, 1, 1, 1, 1, 1, 1, 1, 1, 1, 1, 1, 1, 1, 1, 1, 4, 1, 1, 1, 6, 1, 1, 2, 0, 1, 1, 4 
1, 1, 1, 1, 1, 1, 1, 5, 1, 1, 2, 1, 8, 1, -2, 1, 1, 1, 1, 1, 1, 1, 6, 1, 1, 1, 1, 1, 1, 1, 1, 1, 0, 1, 1, 1, 1, 1, 4, 1, 1, 1, 1, 1, 5, 1, 7, 1, 2, 1, 1, 1, 1, 4, 1, -9, -4, 1, 1, 1, 1, 1, 1, 1, 8, 1, 1, 1, 1, 8 
1, 0, 9, 1, 1, 1, 1, 1, 1, 1, 5, 1, 1, 1, 1, 1, 1, 1, 1, 1, 1, 1, 1, 1, 1, 1, 9, 1, 1, 1, 1, 1, 1, -7, 1, 1, 1, 1, 1, 1, 1, 1, 3, 1, 1, 1, 1, 1, 1, 1, 1, 1, 1, 1, 1, 1, 1, 1, 1, 1, 1, 1, 1, 1, 1, 1, 1, 1, 1, 1 
2, 1, 3, 1, 1, 1, 1, 1, 1, 1, 1, 6, 1, 1, 1, 1, 9, 5, 1, 5, 1, 1, 1, 2, 1, 0, 1, 1, 1, 1, 1, 1, 1, 1, 1, 1, 1, 1, 0, 1, 1, 1, 1, 1, 1, 1, 1, 1, 1, 6, 1, 1, 1, 1, 1, 1, 1, 1, 1, 1, 1, 1, 1, 1, 1, 1, 1, 1, 1, 1 
1, 1, 1, 1, 2, 1, 1, 1, 1, 4, 1, 1, 1, 1, 1, 8, 1, 1, 1, 1, 1, 1, 1, 1, 2, 1, 1, 1, 1, 8, 1, 1, 1, 1, 6, 1, 6, 1, 1, 1, 1, 1, 1, 1, 4, 1, 1, 1, 1, 1, 1, 1, 1, 1, 1, 1, 6, 9, 1, 1, 7, 4, 1, 1, 1, 1, 1, 0, 1, 1 
1, 1, 1, 1, 1, 1, 1, 1, 1, 1, 1, 1, 1, 1, 1, 2, 1, 9, 1, 1, 1, 1, 6, 1, 1, 6, 1, 3, 1, 1, 1, 1, 1, 0, 1, 5, 8, 1, 1, 1, 1, 1, 1, 1, 1, 1, 1, 1, 1, 8, 2, -4, 1, 1, 1, 1, 1, 5, 1, 1, 3, 1, 1, 1, 1, 1, 1, 1, 1, 1 
1, 1, 1, 1, 1, 1, 1, 1, 1, 1, 1, 0, 8, 1, 1, 1, 1, 1, 1, 1, 0, 6, 2, 1, 2, 1, 1, 1, 1, 1, 8, 1, 1, 1, 1, 1, 1, 1, 1, 1, 1, 4, 1, 1, 4, 1, 1, 1, 1, 2, 1, 1, 1, 1, 1, 1, 7, 1, 1, 7, 1, 1, 1, 1, 1, 1, 1, 1, 1, 1 
1, 1, 1, 1, 1, 1, 1, 1, -9, 1, 1, 1, 1, 1, 1, 1, 9, 1, 1, 1, 1, 1, 1, 6, 4, 1, 1, 1, -3, 1, 1, 1, 1, 1, 1, 1, 1, 1, 1, 1, 1, 1, 1, 4, 1, 7, 1, 1, 1, 1, 6, 1, 1, 1, 1, 1, 1, 5, 1, 1, 1, 1, 1, 1, 1, 1, 1, 1, 1, 1 
1, 1, 6, 1, 1, 2, 7, 1, 1, 1, 1, 1, 1, 6, 1, 7, 1, 1, 1, 1, 0, 1, 4, 3, 1, 1, 1, 1, 1, 1, 1, 1, 1, 6, 1, 1, 2, 1, 1, 2, 1, 1, 1, 1, 1, 1, 1, 1, 1, 2, 1, 1, 1, 1, 1, 9, 1, 1, 1, 1, 6, 1, 1, 1, 1, 3, 1, 1, 3, 1 
1, 1, 1, 1, 1, 6, 1, 1, 1, 1, 1, 1, 1, 1, 1, 1, 1, 1, 1, 5, 1, 1, 1, 0, 1, 1, 1, 1, 1, 9, 1, 1, 8, 1, 1, 1, 1, 1, 1, 1, 6, 6, 1, 1, 1, 1, -8, 1, 1, 1, 1, 1, 1, 1, 1, 5, 4, 6, 4, 1, 1, 1, 1, 1, 4, 1, 1, 1, 1, 1 
1, 1, 1, 2, 1, 1, 8, 1, 1, 0, 1, 1, 1, 1, 1, 7, 1, 1, 5, 1, 1, 1, 1, 1, 1, 1, 1, 1, 1, 1, 7, 1, 1, 1, 1, 2, 1, 1, 0, 0, 1, 1, 1, 1, 1, 1, 0, 1, 1, 1, 1, 1, 1, 2, 0, 1, 1, 2, 1, 1, -8, 1, 1, 1, 1, 1, 1, 1, 5, 1 
1, 1, 1, 1, 1, -5, 1, 1, 1, 1, 0, 1, 1, 1, 1, 0, 1, 1, 1, 8, 1, 1, 1, -7, 1, 4, 1, 1, 1, 1, 1, 0, 1, 1, 1, 1, 1, 1, 1, 1, 1, 1, 1, 1, 1, 1, 1, 1, 1, 1, 3, 1, 1, 1, 1, 1, 1, 1, 1, 1, 1, 1, 1, 1, -9, 2, 1, 2, 1, 1 
1, 1, 1, 9, 1, 1, 1, 1, 1, 7, 1, 1, 4, 1, 1, 1, 1, 2, 1, 1, 1, 1, 1, 0, 6, 1, 1, 0, 1, 1, 1, 1, 1, 9, 1, 1, 1, 1, 1, 1, 1, 1, 1, 1, 2, 1, 6, 1, 1, 1, 1, 1, 4, 1, 6, 8, 3, 1, 5, 1, 1, 1, 1, 1, 1, 1, 9, 1, 8, 1 
1, 1, 1, 1, 2, 1, 1, 1, 1, 1, 1, 4, 1, 1, 1, 1, 1, 8, 0, 1, 1, 2, 1, 1, 1, 1, 7, 1, 1, 1, 1, 1, 1, 1, 1, 1, 1, 0, 1, 3, 1, 4, 1, 1, 1, 1, 1, 1, 1, 1, 1, 1, 1, 1, 1, 1, 0, 1, 1, 6, 1, 1, 3, 1, 8, 1, 1, 3, 1, 1 
1, 1, 1, 1, 1, 1, -6, 1, 1, 0, 1, 1, 1, 1, 1, 1, 3, 1, 4, 1, 1, 1, 1, 1, 1, 1, 1, 1, 5, 1, 1, 1, 9, 1, 1, 1, 8, 1, 1, 1, 9, 1, 1, 1, 0, 1, 1, 1, 1, 1, 1, 7, 7, 1, 1, 1, 1, 1, 5, 1, 5, 1, 1, 0, 2, 1, 1, 1, 1, 1 
1, 1, 3, 1, -3, 1, 1, 3, 1, 1, 1, 1, 1, 1, 1, 1, 1, 8, 1, 8, 1, 1, 1, 1, 9, 8, 1, 3, 1, 0, 1, 1, 1, 1, 1, 1, 1, 2, 9, 1, 1, 9, 8, 1, 1, 1, 1, 1, 1, 6, 1, 8, 1, 1, 1, 1, 1, 1, 1, 1, 1, -8, 1, 1, 1, 1, 3, 1, 1, 5 
1, 1, 6, 1, 1, 1, 1, 2, 1, 1, 1, 7, 1, 1, 1, 1, 1, 8, 1, 4, 9, 8, 1, 1, 1, 1, 1, 1, 1, 1, 1, 1, 1, 1, 1, 1, 1, 1, 1, 1, 1, 1, 1, 2, 1, 6, 1, 2, 1, 1, 1, 1, 1, 8, 1, 1, 1, 1, 1, 1, 1, 1, 6, 8, 1, 1, 8, 1, 4, 1 
1, 1, 1, 1, 0, 1, 1, 1, 1, 5, 1, 1, 1, 1, 1, 1, 1, 1, 1, 1, 1, 1, 6, 0, 1, 1, 1, 1, 1, 1, -8, 1, 1, 1, 1, 8, 1, -5, 1, 0, 1, 1, 1, 1, 1, 2, 1, 1, 8, 1, 1, 1, 1, 1, 3, 1, 1, 1, 1, 1, 1, 0, 6, 1, 1, 1, 3, 1, 1, 1 
1, 1, 1, 3, 1, 6, 1, 1, 1, 2, 1, 1, 1, 1, 1, 4, 1, 1, 7, 1, 1, 1, 1, 1, 1, 1, 1, 1, 1, 1, 7, 1, 1, 1, 1, 1, 1, 2, 1, 3, 1, 1, 1, 1, 4, 1, 1, 1, 1, 1, 1, 1, 1, 6, 1, 1, 1, 1, 1, 1, 1, 1, 1, 1, 1, 1, 1, 1, 1, 1 
1, 1, 1, 1, 1, 1, 1, 1, 1, -7, 1, 1, 1, 1, 1, 3, -7, 1, 1, 1, 9, 1, 1, 1, 6, 9, 1, 1, 1, -9, 1, 1, 1, 1, 1, 1, 1, 1, 1, 1, 1, 1, 1, 1, 1, 1, 1, 1, 1, 1, 1, 1, 1, 1, 1, 0, 1, 1, 8, 1, 1, 1, 1, 1, 1, 1, 1, 1, 0, 1 
1, 1, 0, 1, 1, 1, 1, 1, 1, 1, 1, 1, 1, 1, 9, 1, 1, 9, 1, 1, 1, 1, 1, 1, 1, 1, 1, 1, 1, 1, 1, 1, 0, 3, 6, 1, 5, 1, 3, 1, 3, 1, 1, 1, 1, 1, 0, 1, 1, 1, 1, 1, 1, 1, 1, 1, 0, 2, 8, 1, 1, 0, -4, 1, 1, 1, 1, 8, 1, 4 
1, 1, 1, 7, 1, 1, 8, 1, 1, 1, 1, 1, 1, 1, 1, 1, 1, 3, 1, 1, 1, 2, 1, 1, 8, 1, 1, 1, 6, 5, 1, 1, 1, 1, 0, 1, 1, 1, 1, 1, 1, 1, 1, -8, 1, 3, 1, 1, 8, 1, 5, 1, 1, 1, 1, 1, 1, 7, 1, 2, 1, 1, 1, 1, 1, 1, 1, 1, 1, 6 
1, 1, 1, 1, 1, 0, 1, 1, 1, 1, 1, 1, 0, 1, 1, 1, 1, 1, 1, 9, 1, 1, 1, 1, 4, 0, 1, 1, 1, 1, 1, 1, -4, 1, 0, 1, 2, 8, 1, 1, 8, 1, 1, 1, 1, 1, 1, 1, 1, 1, -4, 1, 1, 1, 1, 1, 1, 1, 1, 1, 1, 1, 6, 1, 1, 1, 1, 1, 0, 1 
1, 8, 1, 7, 1, 1, 2, 1, 1, 1, 3, 1, 1, 1, 1, 1, 1, 1, 5, 1, 1, 1, 2, 4, 1, 1, 1, 1, 1, 1, 1, 5, 2, 1, 1, 1, 1, 4, 1, 1, 1, 1, 2, 8, 1, 1, 1, 1, 1, 3, 7, 1, 1, 1, 1, 1, 1, 1, 1, 1, 2, 1, 9, 1, 1, 1, 1, 1, 1, 1 
1, 1, 1, 1, 1, 1, 1, 1, 1, 1, 1, 1, 1, 6, 1, 1, 1, 1, 0, 1, 1, 1, 1, 1, 1, 1, 1, 1, 1, 1, 1, 1, 4, -5, 1, 1, 1, 1, 1, 1, 1, 1, 0, 1, 1, 5, 1, 1, -1, 1, 5, 1, 1, 1, 1, 1, 1, 1, 1, 1, 1, 1, 1, 1, 1, 1, 1, 1, 8, 1 
1, 1, 1, 1, 4, 1, 1, 1, 9, 7, 1, 1, 1, 1, 1, 3, 1, 1, 1, 1, 1, 1, 1, 1, 1, 1, 1, 1, 1, 1, 1, 1, 1, 1, 1, 1, 0, 1, 1, 1, 1, 1, 1, 1, 1, 1, 1, 1, 1, 1, 1, 1, 1, 2, -8, 1, 1, 8, 1, 1, 1, 1, 1, -8, 1, 1, 1, 1, 1, 1 
1, 1, 1, 8, 1, 0, 1, 1, 1, 1, 1, 1, 1, 1, 4, 1, 1, 1, 1, 1, 1, 1, 1, 1, 1, 1, 1, 1, 1, 1, 3, 1, 1, 1, 1, 1, 1, 1, 1, 1, 1, 7, 1, 1, 1, 1, 1, 1, 1, 1, 1, 1, 1, 1, 5, 1, 1, 1, 1, 1, 1, 1, 1, 1, 1, 8, 4, 1, 8, 1 
1, 1, 1, 8, 2, 6, 1, 1, 1, 3, 1, 1, 1, 1, 1, 1, 1, 1, 1, 1, 1, 1, 1, 1, 1, 1, 1, 5, 9, 1, 1, 1, 1, 1, 1, 1, 1, 1, 1, 1, 1, 1, 8, 1, 1, 1, 1, 1, 1, 1, 1, 1, 1, 1, 1, 1, 1, 1, 1, 1, 1, 1, 1, 5, 1, 1, 8, 1, 1, 1 
1, 1, 1, 1, 1, 1, 1, 1, 1, 1, 1, 1, 9, 3, 1, -3, 1, 1, 3, 1, 1, 1, 1, 1, 1, 1, 1, 1, 1, 1, 7, 1, 1, 1, 1, 1, 1, 1, 1, 7, 1, 5, 1, 1, 1, 1, 1, 9, 1, 7, 1, 1, -4, 5, 9, 1, 1, 1, 1, 1, 6, 1, 4, 1, 1, 1, 1, 1, 1, 8 
1, 1, 1, 1, 1, 1, 1, 1, 1, 1, 0, 1, 6, 1, 0, 1, 9, 1, 1, 1, 1, 2, 1, 1, 1, 1, 1, 1, 1, 1, 1, 1, 6, 1, 1, 2, 1, 1, 1, 3, 1, 1, 9, 1, 1, 1, 1, 1, 1, 3, 1, 9, 1, 1, 7, 1, 1, 1, 1, 9, 1, 1, 1, 1, 1, 1, 5, 1, 1, 1 
1, 1, 1, 1, 1, 0, 1, 1, 1, 8, 1, 1, 1, 1, 1, 1, 8, 3, 1, 1, -6, 1, 1, 5, 1, 0, 1, -6, 0, 1, 1, 1, 1, 1, 1, 1, -1, 1, 7, 1, 1, 1, 1, 1, 1, 1, 1, 6, 1, 3, 1, 1, 1, 1, 1, 1, 1, 1, 1, 1, 1, 1, 1, 1, 1, 0, 1, 1, 1, 1 
1, 1, 1, 1, 1, 1, 1, 1, 1, 1, 1, 1, 1, 1, 1, 1, 1, 4, 1, 1, 1, 1, 1, 5, 1, 1, 1, 1, 0, 1, 1, 1, 1, -2, 1, 1, 1, 1, 1, 1, 1, 1, 1, 1, 1, 1, 1, 1, 1, 9, 1, 0, 1, 1, 3, 1, 1, 4, 1, 1, 1, 1, 1, 3, 1, 1, 1, 2, 1, 1 
0, 1, 1, 1, 1, 1, 1, 1, 1, 1, 1, 1, 1, 1, 1, 1, 2, 1, 1, 1, 6, 1, 1, 1, 1, 1, 1, 1, 1, 5, 1, 1, 1, 1, 6, 1, 1, 1, 1, 6, 1, 1, 1, -5, 1, 6, 1, 6, 1, 2, 1, 1, 1, 1, 2, 1, 1, 1, 1, 1, 1, 1, 8, 1, 1, 1, 1, 1, 1, 6 
1, 1, 1, 1, 9, 1, 1, 1, 1, 1, 1, 1, 1, 1, 2, 1, 1, 1, -2, 1, 1, 1, 1, 1, 7, 1, 1, 1, 5, 1, 1, 1, 1, 1, 1, 1, 1, 1, 7, 1, 1, 1, 1, 1, 1, 1, 1, 1, 0, 1, 8, 1, 1, 1, 1, 1, 7, 1, 1, 1, 1, 1, 1, 1, 1, 1, 1, 1, 1, 1 
1, 1, 1, 1, 1, 1, 4, 1, 1, 1, 1, 1, 1, 1, 1, -9, 1, 1, 4, 1, 1, 1, 1, 1, 1, 1, 1, 1, 1, 1, 9, 1, 1, 1, 5, 1, 1, 1, 1, 0, 1, 1, 1, 1, 1, 1, 1, 1, 1, 1, 1, 1, 1, 0, 1, 1, 1, 1, 1, 9, 1, 6, 2, 1, 1, 1, -7, 1, 2, 1 
1, 1, 1, 1, 1, 1, 1, 1, 7, 1, 1, 1, 1, 1, 7, 1, 9, 1, 1, 5, 1, 1, 1, 1, 1, 1, 9, 1, 1, 1, 1, 1, 1, 1, 4, -5, 1, 1, 1, 4, 1, 1, 1, 1, 4, 0, 4, 1, 4, -9, 1, 1, 1, 1, 1, 1, 8, 1, 1, 1, 1, 1, 1, 1, 1, 1, 1, 1, 1, 1 
7, 1, 1, 7, 1, 1, 6, 1, 8, 3, 1, 1, 1, 1, 1, 6, 4, 1, 1, 1, 1, 1, 1, 1, 8, 4, 1, 1, 1, 1, 1, 1, 1, 1, 0, 1, 1, 1, 7, 1, 3, 1, 1, 7, 1, 1, 1, 1, 1, 1, 1, 1, 1, 2, 1, 1, 1, 3, 6, 6, 1, 1, 1, 1, 1, 1, 1, 1, 1, 1 
1, 1, 1, 1, 1, 1, 1, 1, 1, 1, 1, 1, 7, 1, 1, 1, 1, 6, 1, 1, 1, 9, 1, 1, 1, 7, 1, 1, 3, 1, 1, 1, 1, 1, 1, 1, 1, 1, 1, 1, 2, 1, 1, 1, 9, 1, 1, 1, 1, 1, 1, 2, 1, 1, 1, 1, 1, 1, 1, 1, 1, 1, 5, 1, 1, 1, 1, 1, 1, 1 
1, 1, 1, 1, 1, 1, 1, 1, 1, 1, 1, 1, 1, 1, 1, 1, 9, 1, 0, 1, 1, 3, 1, 1, 1, 1, 9, 1, 1, 1, 3, 1, 1, 1, 1, 9, 1, 1, -4, 1, 1, 1, 1, 1, 1, 1, 1, 1, 1, 1, 1, 1, 1, 6, 1, 1, -7, 1, 1, 1, 7, 8, 1, 1, 8, 1, 1, 1, 1, 1 
1, 1, 1, 1, 1, 1, 0, 1, 1, 1, 1, 1, 1, 1, 4, 1, 7, 1, 1, 1, 1, 1, 1, 1, 1, 1, 1, 1, 1, 1, 8, 1, 1, 6, 1, 2, 1, 1, 8, 1, 1, 0, 5, 1, 1, 1, -6, 4, 1, 1, 1, 1, 1, 1, 1, 1, 1, 1, 1, 1, 1, 1, 1, 6, 1, 1, 2, -3, 1, 1 
1, 1, 1, 1, 4, 1, 1, 1, 1, 1, 1, 2, 1, 1, 1, 1, 6, 1, 1, 1, 1, 1, 8, 1, 2, 1, 1, 1, 1, 1, 1, 4, 1, 1, 1, 1, 0, 1, 1, 1, 1, 1, 1, 1, 6, 1, 1, 1, 1, 1, 2, 1, 1, 1, 1, 2, 0, 1, 1, 9, 1, 4, 1, 1, 1, 1, 1, 2, 9, 1 
8, 1, 1, 1, 1, 1, 1, 0, 1, 1, 1, 9, 1, 1, 1, 1, 1, 1, 4, 1, 2, 1, 1, 1, 1, 6, 1, 1, 1, 1, 5, 1, 1, 1, 1, 1, 1, 2, 1, 1, 1, 1, 1, 1, 5, 1, 1, 1, 8, 1, 1, 1, 0, 1, 1, 8, 1, 2, 1, 6, 1, 1, 1, 9, 1, 8, 1, 1, 1, 1 
1, 3, 9, 1, 1, 1, 8, 1, 1, 1, 1, 1, 1, 1, -6, 1, 1, 8, 1, 1, 1, 5, 1, 1, 0, -5, 1, 1, 4, 5, 1, 1, 9, 1, 4, 1, 1, 1, 1, 1, 1, 1, 1, 1, 1, 6, 1, 0, 1, 1, 1, 1, 1, 1, 3, 3, 1, 1, 1, 1, 1, 1, 7, 1, 1, 8, 2, 1, 1, 1 
1, 1, 1, 1, 1, 9, 1, 1, 1, 1, 1, 1, 1, 1, 1, 1, 1, 1, 8, 1, 1, 1, 1, 1, 1, 1, 1, 6, 8, 1, 1, 1, 1, 1, 1, 1, 1, 1, 1, 1, 1, 1, 1, 1, 1, 1, 1, 8, 1, -5, 8, 1, 1, 1, 7, 1, 1, 7, 1, 1, 1, 1, 1, 6, 1, 1, 1, 1, 1, 1 
1, 1, 1, 1, 8, 1, 8, 1, 1, 1, 1, 1, 4, 1, 1, 1, 1, 1, 1, 1, 3, 1, 1, 5, 1, 1, 1, 1, 1, 1, 1, 1, 1, 1, 1, 3, 1, 1, 1, 1, 4, 1, 1, 9, 1, 1, 1, 9, 1, 9, 1, 1, 1, 1, 1, 1, 1, 1, 1, 1, -8, 1, 1, 1, 1, 7, 7, 1, 0, 1 
1, 1, 8, 1, 6, 1, 1, 1, 1, 1, 3, 1, 0, 2, 6, 1, 0, 1, 1, 1, 1, 1, 1, 1, 1, 1, 1, 1, 1, 1, 1, 1, 8, 1, 1, 1, 1, 9, 1, 1, 1, 1, 1, 6, 1, 8, 4, 1, 1, 1, 1, 1, 1, 1, 1, 1, 1, 7, 0, 1, 1, 1, 8, 1, 1, 1, 3, 1, 1, 1 
1, 3, 1, 1, 1, 0, 0, 1, 1, 6, 1, 5, 1, 1, 1, 1, 1, 1, 1, 3, 1, 1, 5, 1, 1, 1, 1, 1, 1, 1, 1, 9, 1, 1, 4, 1, 0, 1, 8, 1, 1, 1, 7, 4, 1, 1, 1, 3, 1, 1, 1, 1, 1, 1, 1, 1, 1, 1, 1, 1, 5, 5, 1, 1, 1, 1, 4, 1, 1, 1 
1, 1, 1, 1, 1, 1, 1, 1, 1, 1, 1, 1, 1, 1, 1, 8, 1, 1, 1, 1, 1, 8, 1, 1, 1, 1, 9, 1, 1, 1, 1, 1, 1, 1, 1, 1, 1, 1, 1, 1, 1, 1, 1, 1, 1, 1, 1, 1, 1, 1, 1, 1, 1, 1, 1, 1, 1, 1, 1, 1, 1, 1, 1, 1, 1, 1, 1, 1, 1, 1 
1, 1, -3, 1, 1, 7, 1, 1, 1, 1, 1, 1, 1, 1, 1, 1, 6, 1, 1, 1, 1, 1, 1, 1, 1, 1, -6, 1, 8, 2, 1, 8, 1, 1, 1, 1, 1, 1, 1, 1, 1, 1, 1, 1, 1, 1, 1, 1, 1, 1, 1, 1, 7, 1, 1, 1, 1, 1, 1, 1, 5, 1, 6, 1, 1, 1, 1, 1, 1, 1 
1, 1, 1, 1, -3, 1, 1, 4, 1, 1, 1, 8, 1, 5, 1, 1, 1, 4, 1, 1, 1, 1, 1, 1, 1, 5, 1, 1, 1, 7, 1, 1, 1, 1, 1, 1, 1, 1, 1, 1, 1, 1, 1, 1, 1, 1, 5, 1, 1, 3, 1, 3, 1, 7, 1, 1, 1, 1, 3, 3, 1, 1, 1, 1, 9, 1, 1, 1, 4, 1 
1, 1, 1, 1, 1, 3, 1, 1, 1, 1, 1, 1, 1, 1, 1, 6, 1, 1, 1, 1, 2, 4, 1, 1, 1, 1, 1, 1, 1, 1, 1, 1, 7, 1, 1, 1, 1, 5, 1, 1, 1, 1, 1, 1, 1, 1, 1, 2, 1, 1, 1, 1, 1, 1, 1, 1, 1, 1, 1, 7, -2, 1, 1, 1, 1, 4, 2, 1, 9, 8 
1, 1, 1, 1, 1, 1, 1, 1, 1, 1, 1, 1, 1, -3, 4, 1, 4, 1, 1, 7, 1, 1, 6, 1, 1, 1, 9, 1, 1, 9, 1, 1, 1, 1, 5, 1, 1, 1, 1, 1, 1, 1, 1, 1, 1, 1, 6, 1, 2, 1, 1, 1, 1, 1, 1, 1, 6, 2, 1, 6, 1, 9, 1, 5, 1, 1, 1, 1, 1, 8 
1, 1, 1, 1, 1, 1, 1, 1, 1, 1, 1, 1, 1, 1, 6, 1, 1, 1, 1, 3, 1, 1, 7, 1, 1, 1, 1, 1, 1, 1, 2, 1, 1, 4, 1, 1, 7, -4, 7, 1, 1, 9, 5, 1, 1, 1, 1, -8, 1, 1, 1, -8, 1, 0, 1, 1, 1, 1, 1, 9, 7, 1, 1, 1, 1, 1, 1, 1, 9, 1 
1, 3, 1, 1, 1, 1, 1, 1, 0, 3, 1, 1, 1, 1, 1, 1, 1, 1, 1, 1, 1, 1, 1, 1, 1, 1, 1, 1, 1, 1, 2, 1, 1, 1, 1, 6, 1, 1, 1, 1, 1, 4, 1, 1, 1, 1, 1, 1, 1, 1, 1, 1, 1, 9, 1, 1, 1, 1, 0, 1, 1, 1, 1, 1, 1, 1, 1, 1, 5, 1 
