10, 10
35
5,1,1,1,1,1,1,1,1,1,1,3,1,1,1,1,1,1,1,1,1,1,1,5,0,1,1,1,1,1,4,1,2,1,1
1,1,1,2,1,1,1,1,1,1,0,1,1,1,1,1,1,1,1,1,1,1,1,1,1,1,1,6,1,1,2,-5,1,1,1
1,1,1,1,1,3,3,1,6,1,1,9,1,1,1,1,1,1,1,1,1,1,1,1,2,1,1,1,1,1,1,1,1,6,1
1,9,1,1,1,7,7,7,7,-9,-9,1,8,-3,1,1,5,5,1,1,1,4,2,1,1,1,1,4,1,1,1,1,1,1,1
1,1,1,6,7,7,7,7,7,-9,-9,1,7,4,1,1,5,1,4,1,1,1,1,1,1,1,1,1,1,1,1,1,1,1,0
1,1,2,1,7,7,7,7,7,-9,-9,1,1,1,1,4,1,1,5,1,1,1,1,1,1,1,1,1,1,1,1,1,2,1,1
1,1,1,1,1,-9,-9,-9,-9,1,1,7,9,1,0,1,3,3,1,1,1,1,1,1,0,9,9,1,1,5,1,1,1,2,1
2,4,1,1,1,-9,-9,-9,-9,1,-9,-2,1,1,4,2,1,2,1,1,1,1,1,1,1,1,1,1,1,1,1,1,1,1,1
1,1,1,1,1,1,1,1,1,1,1,-9,-3,1,1,1,1,1,1,1,7,1,4,1,1,1,1,1,1,1,4,1,1,1,1
1,1,1,1,0,1,4,1,1,1,1,1,1,1,1,1,1,1,1,1,1,1,1,1,1,1,1,1,1,1,1,1,1,1,1
9,1,3,1,1,1,1,1,4,1,0,1,1,3,1,1,1,1,1,3,1,1,1,1,1,1,0,1,7,1,1,1,1,8,1
5,1,1,1,1,1,1,2,3,1,1,1,1,1,1,1,1,1,1,1,1,1,1,1,0,1,7,1,1,1,1,1,1,1,1
1,1,1,1,1,3,3,5,4,1,7,1,1,1,1,1,1,1,1,4,1,1,1,1,1,1,1,0,1,1,1,1,1,1,1
1,1,1,1,1,1,1,1,1,1,1,1,1,1,1,1,1,1,9,1,1,1,1,1,6,1,1,1,1,1,1,1,1,1,1
1,1,1,1,1,1,1,1,1,5,1,1,1,1,1,1,1,1,2,6,4,2,1,1,1,1,1,5,1,1,1,9,1,0,1
1,1,1,1,1,1,1,1,1,8,1,1,1,1,1,1,1,1,2,0,1,1,4,1,1,1,1,2,1,1,-2,1,1,1,1
1,1,1,1,5,1,1,0,1,1,1,1,3,4,4,1,1,1,0,1,0,1,1,1,1,1,1,1,7,1,1,1,8,1,1
1,1,1,1,1,1,3,1,0,5,1,1,4,1,2,1,9,3,1,1,7,5,1,7,1,1,0,1,1,1,1,1,1,5,1
1,1,1,1,9,1,6,1,1,1,9,1,1,1,1,1,1,1,1,1,8,1,1,1,1,1,1,1,1,1,1,1,1,1,1
1,1,0,8,1,1,1,1,1,1,1,1,4,1,1,1,1,1,1,1,1,1,1,1,1,8,1,1,1,1,5,1,4,1,4
4,1,1,6,1,1,9,1,1,1,1,3,7,1,1,1,1,1,1,2,1,3,1,1,9,1,1,1,1,1,1,1,1,8,1
1,1,1,1,1,1,1,0,1,1,1,1,1,0,1,1,1,4,1,1,1,1,1,1,1,1,1,1,2,1,6,1,1,1,4
1,1,1,1,6,1,1,5,1,1,2,1,4,1,1,3,1,1,1,2,1,1,1,1,4,5,1,1,1,1,9,1,1,1,1
2,0,1,1,1,1,1,1,1,1,1,1,1,1,8,1,1,1,1,1,1,3,1,1,1,1,1,1,1,3,-5,1,1,1,1
1,1,1,1,1,3,1,1,1,1,1,8,1,1,1,1,1,1,1,1,1,1,1,1,6,1,1,1,1,9,6,1,9,8,1
1,1,5,1,1,1,1,1,1,1,1,1,0,1,1,1,1,1,1,1,1,1,1,1,1,5,4,1,1,1,6,1,1,1,8
1,1,1,1,9,1,1,1,1,1,9,1,1,1,1,1,1,2,6,1,1,1,1,2,1,1,7,1,1,1,7,1,1,-6,1
2,1,8,5,1,1,1,1,1,1,1,1,5,1,1,1,1,1,1,1,1,1,1,-6,1,1,1,1,1,1,1,2,1,1,1
1,1,1,1,1,1,1,1,1,3,1,1,1,1,1,1,1,1,9,1,1,7,1,1,1,1,1,1,1,1,2,7,1,1,1
1,1,6,1,1,7,1,4,1,1,4,1,1,1,9,1,1,1,1,1,2,1,1,1,1,1,1,1,1,1,1,1,1,1,1
-1,1,1,1,1,1,8,1,1,6,1,3,1,1,1,7,1,1,1,1,1,1,1,1,1,1,1,1,1,1,1,1,1,1,1
8,1,1,1,1,1,1,-6,1,1,4,1,1,1,0,1,1,1,1,1,0,1,1,7,1,1,2,7,1,1,1,1,2,1,1
1,1,7,1,1,1,1,1,1,1,1,1,1,7,1,8,1,1,8,1,1,1,1,1,1,3,6,1,1,1,1,1,1,1,1
1,1,6,1,1,1,6,3,1,1,1,1,0,1,1,1,1,1,0,1,1,1,1,1,1,1,1,1,1,1,1,1,1,1,1
1,1,1,1,1,1,1,-2,1,1,1,1,1,9,8,1,1,1,1,1,1,1,1,1,-6,1,1,1,4,1,1,1,1,1,1
